11111111
1P001001
10011001
100100E1
11111111