111111111111
1P00000C01E1
100000000101
100000C00101
100C00000101
100000000001
111111111111