111111111111
1P00010C01E1
100100011101
100100C00101
111110101101
10C000000001
111111111111