1111111111111111111111
10P010C010X00001000001
100010001000100000C001
1000100010C01X01000001
1000110111111001111111
1000000000000000000001
111100X000000000110011
1E0111000000000X100001
100000000X00000010C0X1
1111111111111111111111