1111111111
1P11111111
1011111111
10111111111
1000000E11
1111111111